##################################################
#...O.O..O..O...O..........O.O.O.O.....O..O.#.O#.#
#...O.OO.O.......O#.......O.OO....O.#..#...OOO#..#
#O..O....O.O.O.O..O.OOO...O.OO......O....#O.....##
#OO.#O.........OOO....OO....O.O.O..#......OO.O...#
#OO........OOO#O..#O..OOO...O.O.O..OO.#OOOO...#.##
#....#.O.......O.#....OOOO.O..O..O.O##...O....#O##
#.....OOO....O..........O...OO......OO.OO#O...OO.#
#OO.O....O...OO.O.##....OOO.O...O...............##
#O.....O.....#.....#..O..#O.O.O..OO#O..O.OOO...O.#
#.O....O....O..O.O...#.O..O....O.O..O..O.....O...#
#.O.O.....OO.OOOO.O...#O..........O...#.#OO....O.#
#O..O.O.O..O.O....OOO..O#..O.O.O......#O..O.O.#O##
#..O#...O.OO.....#O..O..O....OOOO.O...#OOO..#.#.O#
#.O.....O#.............#.#..OO...OOO....O....OO###
#.#OO....OO..O#....OO..O#...OO..........O...OO...#
#.O.O.....OO.....O.OO.O#...O..O..O...O....O......#
#.O..O....O..O.....#O.O..O.....O..#O...OOOO.O...O#
#O...O....O.OOOO...OO.........O#..#.....#O.O#O#.O#
##...OO...O.....O..O#O...O.........O.#...#..#....#
#OOOO.OO.#...OO.#..O..#O...........OOOO.OO.O....O#
#....O..O.O.OO..O#......#.....OO..OO...O........##
#.O.#....#..........#..OO....OO....##........O.OO#
#..O.O..#.....O##O.O....OO......#O....O....#.....#
#....OO.OO#..OO..O.#....@#O.OOO.O..OO#...#O.OO...#
#..O.....O.........O.O........O#O......O.......O.#
#O.............O....#O.......O..#..#O.O.O...#....#
##...O...OOO..OO..OO.........OOOOO..O.O.O.OO..O.O#
#.#.OOO......#.O..OO.#...O#.O....O..#...#.O......#
#O.O..........O..O...O..OO....O#.O....O.OOO....#.#
#.O.#..OO.OO#..........#.O...O.OO.....O......O.O.#
#.......OO.O.#O..OO.OOO.O........O.............OO#
#O..OOO.#.OO.O.O.....O...O.O..OO.O...O#O##O..O...#
#O.#.O.#O....O..O......O.##O.OOO..O.OOO.O...#....#
#.#........O.OO...#.O...O.....O.##...#.O.OO.O..#O#
#..OO..O....#..O.O#O..O...#O...O#.O.O.O.O...O.#..#
#O.......O#.#O..O#..O..O...#.#.O...........OO....#
#O....................OO.O...O......#..#.OO......#
#OO#..O#....O.OOO.....OOO..#.O..#OO.#....#O.O.O..#
#.O..O.......O.O....#.O...OO....O.OOO...#........#
#.......O...#.....###...O.OO.....O...##..O.#...O.#
#.O.#O...O...O.O#.#..#.#O..O.OO...O#...OOOO.O...O#
##..OO..........O...O.#...OO#O...#O..O..O........#
#...O..O.OO...#O..O#....O....#......OOOO.O...O.O.#
#..O.O...O.O.#O..O.O..#.O.O.......#....O....O.O..#
#O.O.#.OO.....O.........O.##..OO...#.O..O........#
#O..O.OOO..#....O.O#O.O..O......O...O#.OOO.O.O.O.#
#.O....##.##O.O.OO##.O...O....#...#.OO.....O...O.#
#OOO.....#...OOO.O..OOO..O...O......#.O...O..##.O#
##################################################